%%%%%%%%%%%%%%%%%%%%
%......%G..G%......%
%.%%...%%..%%...%%.%
%.%..%........%..%.%
%.%%.%.%%%%%%.%.%%.%
%........P.........%
%%%%%%%%%%%%%%%%%%%%